1 5
1 1 1 1 1 1 0 0 0 0
1 3 3 4 3 1 0 0 0 0
1 3 2 0 0 1 0 0 0 0
1 1 0 2 0 1 0 0 0 0
1 1 2 0 1 1 0 0 0 0
1 0 2 0 1 0 0 0 0 0
1 1 0 0 1 0 0 0 0 0
0 1 1 1 1 0 0 0 0 0
0 0 0 0 0 0 0 0 0 0
0 0 0 0 0 0 0 0 0 0